CARMINVM NVMERI GESNERIANI
CVM TITVLIS ET NVMERATIONE CARMINVM Hvivs EDITIONIS

COMPOSITI.
I: paneg. Probini et Olybrii. XLIX: e. m. XXVI.
II In Rufinum I praef. L: c. m. XVII.
III In Rufinum I. LI: c.. m. XVIII.
IV: In Rufinum ΙΙ praef. LII: c, m. XX.
V: In Rufinum II. LIII: c. m. XLII.
VI: De III consulatu Honorii praef. LIV: c. m. IV.

VII: Paneg. de III cons. Hon. LV: c. m. XLV.

VIII: paneg. de IV cons. Hon. LVI—LXII: e. m. XXXIII-XXXIX.
IX: Nuptiarum Hon. et Mariae praef. LXIII: carm. Graec. epigramm. IV.
X: Nuptiae Honorii et Mariae. LXIV: carm. Graec.. epigramm. V.
XI: Fescennin. Ι. LXV: carm. Graec. epigramm. Ι.

XII: Fescenn. II. LXVI: carm. Graec. epigramm. III.

XIII: Fescenn. III. LXVII: earm. Graec. epigramm. II.

XIV: Fescenu. IV. LXVIII: carm. minor. LI.

XV: Bellum Gildonicum. LXIX: carm. min. VIII.

XVI: Paneg. Manlii Theodori praef. LXX: earm. min. XLVIII.
XVII: Paneg. Manlii Theodori. LXXI: carm. min. append. IV.
XVIII: In Eutropium I. LXXII: curm. min. XLVI.

XIX: In Eutropium II praef. LXXIII: c. m. XLVII.

XX: In Eutropitlm II. LXXIV: c. m. XXIII.

XXI: De consulatu Stilichonis I. LXXV: c. m. XLIII.

XXII: De consulatu Stil. II. LXXVI: o. m. XLIV.

XXIII: De consulatu Stil. III praef. LXXVII: e. m. L.
XXIV: De consulatu Stil. III. LXXVIII: c. m. VI.
XXV: Belli Pollentini praef. LXXIX: c. m. XIII.
XXVI: Bellum Pollentinum. LXXX: C. m. XXI.

XXVII: I'anog. de VI cons. Honorii praef. LXXXI: c. m. III.

XXVIII: I‘ztneg. «le VI cons. Honorii. LXXXII: c. m. XIV.
XXIX: carm. minor. XXX. LXXXIII: ι). ιιι, XXIV.
XXX: carm. min. XXV praef. LXXXIV: C. m. XII.
XXXI: (urm. min. XXV. LXXXV: c. m. II.

XXXII: Raptus Proserpinae Ι praef. LXXXVI: c. m. V.' -

XXXIII: Raptus Pron: I. LXXXVII: c.. ιιι. VII.

XXXIV: Iluptus Pros. II praes. LXXXVIII: ν. ιιι. LII.

XX‘XV: Iluptus '‘x-os. II. LXXXIX: c.. ιιι. XV.

XXXVI: Raptus l'ros. III. XC: c. 111. XVI.

XXXVII: curin. minor. LIII. XCI: υ, ιιι. XI.

XXXVIII: curm. Grave. l'tyurtopmyia. XCII: υ. m. X.

XXXIX: ι·;ιι·ιιι. minor. XXII. XCIII: curm. inin. append. IX.
XL: (utrm. min. XXXI. XCIV: carm, min. append. X.
XLI: (urm. ιιι. XL. XCV: exirm. min. XXXII.

XLII: ι’. ιιι. XLI. XCVI: curm. Graec. epigr. VI.
XLIII: r. ιιι, XIX. xovll: curm. Graec. epigr. VII.

' XLIV: v. ιιι, XXVII. XCVIII: curm. min. append. XX.
XLV: υ. ιιι. IX. XCIX: υ. min. append. XXI.
XLVI: ‹·. ιιι. XLIX. C: c. nun. append. I.

XLVII: ι’, ιιι. XXVIII. ul: (κ ιιιίιι, append. II.

XLVIII: ‹·. ιιι. XXIX.

 

 

